#############################################
#                                           #
#    ·  · · ·   ··                          #
#####################  ######################
#                                           #
#                                           #
#    ######· ################               #
#         #· #· · · · ·                     #
#         #· #################              #
#                                           #
#                                           #
#                                           #
#############################################
